Registrar rol: CREATE-ROLES [NOMBRE]
Actualizar rol: UPDATE-ROLES [ID,NOMBRE]
Eliminar rol: DELETE-ROLES [id]
Listar roles: LIST-ROLES [] || LIST-ROLES [KEY, VALOR]

Actualizar usuario: UPDATE-USUARIOS [ID, NOMBRE, CORREO, CONTRASEÃ‘A, ROL_ID]
Eliminar usuario: DELETE-USUARIOS [id]
Listar usuarios: LIST-USUARIOS [] || LIST-USUARIO [KEY, VALOR]

Registrar Estudiantes: CREATE-ESTUDIANTES [CI,NOMBRE,APELLIDO_PAT,APELLIDO_MAT,TELEFONO,SEXO,FECHA NACIMIENTO,USER_ID=0,EMAIL]
Actualizar Estudiantes: UPDATE-ESTUDIANTES [CI,NOMBRE,APELLIDO_PAT,APELLIDO_MAT,TELEFONO,SEXO,FECHA NACIMIENTO,USER_ID,EMAIL]
Eliminar Estudiantes: DELETE-ESTUDIANTES [CI]
Listar Estudiantes: LIST-ESTUDIANTES [] || LIST-ESTUDIANTES [KEY, VALOR]

Registrar Docentes: CREATE-DOCENTES [CI,NOMBRE,APELLIDO_PAT,APELLIDO_MAT,TELEFONO,KARDEX,CURRICULUM,EMAIL,USER_ID=0]
Actualizar Docentes: UPDATE-DOCENTES [CI,NOMBRE,APELLIDO_PAT,APELLIDO_MAT,TELEFONO,KARDEX,CURRICULUM,EMAIL,USER_ID]
Eliminar Docentes: DELETE-DOCENTES [CI]
Listar Docentes: LIST-DOCENTES [] || LIST-DOCENTES [KEY, VALOR]

Registrar Administrativos: CREATE-ADMINISTRATIVOS [CI,NOMBRE,APELLIDO_PAT,APELLIDO_MAT,TELEFONO,SEXO,FECHA NACIMIENTO,USER_ID=0,EMAIL]
Actualizar Administrativos: UPDATE-ADMINISTRATIVOS [CI,NOMBRE,APELLIDO_PAT,APELLIDO_MAT,TELEFONO,SEXO,FECHA NACIMIENTO,USER_ID,EMAIL]
Eliminar Administrativos: DELETE-ADMINISTRATIVOS [CI]
Listar Administrativos: LIST-ADMINISTRATIVOS [] || LIST-ADMINISTRATIVOS [KEY, VALOR]

Registrar Gestiones: CREATE-GESTIONES [DESCRIPCION, FECHA_INI,FECHA_FIN]
Actualizar Gestiones: UPDATE-GESTIONES [COD,DESCRIPCION, FECHA_INI,FECHA_FIN]
Eliminar Gestiones: DELETE-GESTIONES [COD]
Listar Gestiones: LIST-GESTIONES [] || LIST-GESTIONES [KEY, VALOR]

Registrar carreras: CREATE-CARRERAS [COD,DESCRIPCION,COD_GESTION]
Actualizar carreras: UPDATE-CARRERAS [COD, DESCRIPCION,COD_GESTION]
Eliminar carreras: DELETE-CARRERAS [COD]
Listar carreras: LIST-CARRERAS [] || LIST-CARRERAS [KEY, VALOR]

Registrar materias: CREATE-MATERIAS [SIGLA,DESCRIPCION,OBSERVACION,CREDITOS]
Actualizar materias: UPDATE-MATERIAS [SIGLA,DESCRIPCION,OBSERVACION,CREDITOS]
Eliminar materias: DELETE-MATERIAS [SIGLA]
Listar materias: LIST-MATERIAS [] || LIST-MATERIAS [KEY, VALOR]

Registrar niveles: CREATE-NIVELES [NOMBRE]
Actualizar niveles: UPDATE-NIVELES [ID,NOMBRE]
Eliminar niveles: DELETE-NIVELES [ID]
Listar niveles: LIST-NIVELES [] || LIST-NIVELES [KEY, VALOR]
